//  数字の色は　黒(0)　赤(1)　緑(2)　 黄色(3)　　青(4)　ピンク(5)　水色(6)　　白(7)
//  ＜注意＞黒はブロックなし

int	g_BlockData[ STAGE ][ HEIGHT ][ WIDTH ] = {	// ブロック配列
	{	// 0ｽﾃｰｼﾞ
		{ 1 , 1 , 1 , 1 , 1 , 1 , 1 , 1 , 1 , 1 , 1 , 1 , 1 , 1 , 1 , 1 },
		{ 1 , 1 , 1 , 1 , 1 , 1 , 1 , 1 , 1 , 1 , 1 , 1 , 1 , 1 , 1 , 1 },
		{ 1 , 1 , 1 , 1 , 1 , 1 , 1 , 1 , 1 , 1 , 1 , 1 , 1 , 1 , 1 , 1 },
		{ 1 , 1 , 1 , 1 , 1 , 1 , 1 , 1 , 1 , 1 , 1 , 1 , 1 , 1 , 1 , 1 },
		{ 1 , 1 , 1 , 1 , 1 , 1 , 1 , 1 , 1 , 1 , 1 , 1 , 1 , 1 , 1 , 1 },
		{ 1 , 1 , 1 , 1 , 1 , 1 , 1 , 1 , 1 , 1 , 1 , 1 , 1 , 1 , 1 , 1 },
		{ 1 , 1 , 1 , 1 , 1 , 1 , 1 , 1 , 1 , 1 , 1 , 1 , 1 , 1 , 1 , 1 },
		{ 1 , 1 , 1 , 1 , 1 , 1 , 1 , 1 , 1 , 1 , 1 , 1 , 1 , 1 , 1 , 1 },
		{ 1 , 1 , 1 , 1 , 1 , 1 , 1 , 1 , 1 , 1 , 1 , 1 , 1 , 1 , 1 , 1 },
		{ 1 , 1 , 1 , 1 , 1 , 1 , 1 , 1 , 1 , 1 , 1 , 1 , 1 , 1 , 1 , 1 }
	},
	{	// 1ｽﾃｰｼﾞ
		{ 0 , 0 , 0 , 0 , 0 , 0 , 2 , 2 , 2 , 2 , 0 , 0 , 0 , 0 , 0 , 0 },
		{ 0 , 0 , 0 , 0 , 0 , 2 , 3 , 3 , 3 , 3 , 2 , 0 , 0 , 0 , 0 , 0 },
		{ 0 , 0 , 0 , 2 , 2 , 3 , 4 , 4 , 4 , 4 , 3 , 2 , 2 , 0 , 0 , 0 },
		{ 0 , 2 , 2 , 3 , 3 , 4 , 5 , 5 , 5 , 5 , 4 , 3 , 3 , 2 , 2 , 0 },
		{ 2 , 3 , 3 , 4 , 4 , 5 , 0 , 0 , 0 , 0 , 5 , 4 , 4 , 3 , 3 , 2 },
		{ 2 , 3 , 3 , 4 , 4 , 5 , 0 , 0 , 0 , 0 , 5 , 4 , 4 , 3 , 3 , 2 },
		{ 0 , 2 , 2 , 3 , 3 , 4 , 5 , 5 , 5 , 5 , 4 , 3 , 3 , 2 , 2 , 0 },
		{ 0 , 0 , 0 , 2 , 2 , 3 , 4 , 4 , 4 , 4 , 3 , 2 , 2 , 0 , 0 , 0 },
		{ 0 , 0 , 0 , 0 , 0 , 2 , 3 , 3 , 3 , 3 , 2 , 0 , 0 , 0 , 0 , 0 },
		{ 0 , 0 , 0 , 0 , 0 , 0 , 2 , 2 , 2 , 2 , 0 , 0 , 0 , 0 , 0 , 0 }
	},
	{	// 2ｽﾃｰｼﾞ
		{ 7 , 7 , 7 , 7 , 7 , 7 , 7 , 7 , 7 , 7 , 7 , 7 , 7 , 7 , 7 , 7 },
		{ 7 , 7 , 7 , 7 , 7 , 7 , 7 , 7 , 7 , 7 , 7 , 7 , 7 , 7 , 7 , 7 },
		{ 0 , 6 , 6 , 6 , 6 , 6 , 6 , 6 , 6 , 6 , 6 , 6 , 6 , 6 , 6 , 0 },
		{ 0 , 0 , 6 , 6 , 6 , 6 , 6 , 6 , 6 , 6 , 6 , 6 , 6 , 6 , 0 , 0 },
		{ 0 , 0 , 0 , 5 , 5 , 5 , 5 , 5 , 5 , 5 , 5 , 5 , 5 , 0 , 0 , 0 },
		{ 0 , 0 , 0 , 0 , 5 , 5 , 5 , 5 , 5 , 5 , 5 , 5 , 0 , 0 , 0 , 0 },
		{ 0 , 0 , 0 , 0 , 0 , 4 , 4 , 4 , 4 , 4 , 4 , 0 , 0 , 0 , 0 , 0 },
		{ 0 , 0 , 0 , 0 , 0 , 0 , 4 , 4 , 4 , 4 , 0 , 0 , 0 , 0 , 0 , 0 },
		{ 0 , 0 , 0 , 0 , 0 , 0 , 0 , 3 , 3 , 0 , 0 , 0 , 0 , 0 , 0 , 0 },
		{ 0 , 0 , 0 , 0 , 0 , 0 , 0 , 3 , 3 , 0 , 0 , 0 , 0 , 0 , 0 , 0 }
	},
	{	// 3ｽﾃｰｼﾞ
		{ 0 , 1 , 1 , 0 , 0 , 0 , 0 , 0 , 0 , 0 , 0 , 0 , 0 , 0 , 0 , 0 },
		{ 0 , 1 , 1 , 2 , 2 , 0 , 0 , 0 , 0 , 0 , 0 , 0 , 0 , 0 , 0 , 0 },
		{ 0 , 1 , 1 , 2 , 2 , 0 , 0 , 0 , 0 , 0 , 0 , 0 , 0 , 0 , 0 , 0 },
		{ 0 , 1 , 1 , 2 , 2 , 3 , 3 , 0 , 0 , 0 , 0 , 0 , 0 , 0 , 0 , 0 },
		{ 0 , 1 , 1 , 2 , 2 , 3 , 3 , 4 , 4 , 0 , 0 , 0 , 0 , 0 , 0 , 0 },
		{ 0 , 1 , 1 , 2 , 2 , 3 , 3 , 4 , 4 , 5 , 5 , 0 , 0 , 0 , 0 , 0 },
		{ 0 , 1 , 1 , 2 , 2 , 3 , 3 , 4 , 4 , 5 , 5 , 6 , 6 , 0 , 0 , 0 },
		{ 0 , 1 , 1 , 2 , 2 , 3 , 3 , 4 , 4 , 5 , 5 , 6 , 6 , 7 , 7 , 0 },
		{ 0 , 1 , 1 , 2 , 2 , 3 , 3 , 4 , 4 , 5 , 5 , 6 , 6 , 7 , 7 , 0 },
		{ 0 , 1 , 1 , 2 , 2 , 3 , 3 , 4 , 4 , 5 , 5 , 6 , 6 , 7 , 7 , 0 }
	},
	{	// 4ｽﾃｰｼﾞ
		{ 7 , 1 , 0 , 0 , 1 , 7 , 3 , 3 , 3 , 0 , 7 , 0 , 4 , 4 , 0 , 7 },
		{ 7 , 1 , 0 , 1 , 1 , 7 , 3 , 0 , 0 , 3 , 7 , 4 , 4 , 4 , 4 , 7 },
		{ 7 , 1 , 1 , 1 , 0 , 7 , 3 , 0 , 0 , 3 , 7 , 4 , 0 , 0 , 4 , 7 },
		{ 7 , 1 , 1 , 0 , 0 , 7 , 3 , 0 , 0 , 3 , 7 , 4 , 0 , 0 , 0 , 7 },
		{ 7 , 1 , 0 , 0 , 0 , 7 , 3 , 3 , 3 , 0 , 7 , 4 , 0 , 0 , 0 , 7 },
		{ 7 , 1 , 1 , 0 , 0 , 7 , 3 , 0 , 0 , 3 , 7 , 4 , 0 , 0 , 0 , 7 },
		{ 7 , 1 , 1 , 1 , 0 , 7 , 3 , 0 , 0 , 3 , 7 , 4 , 0 , 0 , 4 , 7 },
		{ 7 , 1 , 0 , 1 , 1 , 7 , 3 , 0 , 0 , 3 , 7 , 4 , 4 , 4 , 4 , 7 },
		{ 7 , 1 , 0 , 0 , 1 , 7 , 3 , 3 , 3 , 0 , 7 , 0 , 4 , 4 , 0 , 7 },
		{ 7 , 7 , 7 , 7 , 7 , 7 , 7 , 7 , 7 , 7 , 7 , 7 , 7 , 7 , 7 , 7 }
	}
};
